Xu, Xu, Xu, Xu, Xu, Xu, Xu, Xu, Xu, Xu, Xu, Xu, Xu, Xu, Xu, Xu, Xu, Xu, Xu, Xu, Xu, Xu, Xu, Xu, Xu, Xu, Xu, Xu, Xu, Xu, Xu, Xu, Xu, Xu, Xu, Xu, Xu, Xu, Xu, Xu, Xu, Xu, Xu, Xu, Xu, Xu, Xu, Xu, Xu, Xu, Xu, Xu, Xu, Xu, Xu, Xu, Xu, Xu, Xu, Xu, Xu, Xu
Xu, Xu, Xu, Xu, Xu, Xu, Xu, Xu, Uu, Xu, Xu, Xu, Uu, Xu, Xu, Xu, Uu^Vud, Xu, Xu, Xu, Uu, Xu, Uu^Vud, Xu, Uu, Xu, Xu, Xu, Xu, Xu, Xu, Xu, Xu, Xu, Xu, Xu, Xu, Xu, Xu, Xu, Xu, Xu, Xu, Xu, Uu^Tf, Xu, Xu, Xu, Xu, Xu, Xu, Xu, Xu, Xu, Xu, Xu, Xu, Xu, Xu, Xu, Xu, Xu
Xu, Xu, Xu, Xu, Xu, Xu, Xu, Uu^Vud, Uu, Uu, Xu, Rr, Rr, Uu, Xu, Uu, Uu, Uu, Xu, Uu, Uu, Xu, Uu, Uu, Uu, Uu, Xu, Xu, Xu, Xu, Xu, Xu, Xu, Xu, Xu, Xu, Xu, Xu, Uu^Tf, Xu, Qxu, Xu, Uu^Tf, Uu^Tf, Uu, Xu, Xu, Xu, Xu, Xu, Xu, Xu, Xu, Xu, Xu, Xu, Xu, Xu, Xu, Xu, Xu, Xu
Xu, Xu, Xu, Xu, Xu, Xu, Xu, Uu, Uu, Uu, Uu, Xu, Rr, Uu, Xu, Uu, Xu, Uu, Xu, Rr, Uu, Xu, Uu, Uu, Uu, Uu, Xu, Xu, Xu, Xu, Xu, Xu, Xu, Xu, Xu, Xu, Qxu, Uu^Tf, Uu, Uu^Tf, Uu, Uu, Uu, Xu, Uu, Uh, Uh, Xu, Xu, Xu, Uu, Xu, Uu, Uu^Tf, Xu, Xu, Xu, Xu, Xu, Xu, Xu, Xu
Xu, Xu, Xu, Xu, Xu, Xu, Xu, Xu, Xu, Xu, Xu, Xu, Rr, Uu, Uu, Xu, Uu^Vud, Xu, Uu^Vud, Rr, Uu, Xu, Xu, Xu, Xu, Xu, Xu, Xu, Xu, Xu, Xu, Xu, Xu, Xu, Xu, Xu, Uu, Uu, Uu, Uu, Uu, Xu, Uu, Uu, Xu, Uh, Uh, Xu, Xu, Uu^Tf, Xu, Uu, Uu, Uu^Tf, Uu^Tf, Xu, Xu, Xu, Xu, Xu, Xu, Xu
Xu, Xu, Xu, Xu, Xu, Xu, Xu, Uu, Uu, Uu, Rr, Rr, Cud, Cud, Cud, Rr, Rr, Rr, Rr, Rr, Uu, Uu, Uu, Uu, Rr, Uu, Xu, Xu, Uu, Xu, Uu, Xu, Uu, Xu, Uu, Xu, Uu, Uu, Uu, Uu, Uu, Qxu, Qxu, Uu, Uu, Uh, Uu, Xu, Uu, Uu^Tf, Uu, Xu, Qxu, Uh, Uh, Xu, Xu, Xu, Xu, Xu, Xu, Xu
Xu, Xu, Xu, Xu, Xu, Xu, Xu, Uu^Vud, Uu, Rr, Rr, Rr, Cud, 4 Kud, Cud, Rr, Rr, Rr, Rr, Rr, Rr, Rr, Rr, Rr, Rr, Rr, Xu, Uu, Xu, Uu, Xu, Uu, Xu, Uu, Xu, Uu, Uu, Uh, Uh, Uu, Uu, Khr, Uu, Uu, Uu, Uu, Xu, Uu, Uu, Uu, Uu, Uu, Uu, Uh, Xu, Xu, Xu, Xu, Xu, Xu, Xu, Xu
Xu, Xu, Xu, Xu, Xu, Xu, Xu, Uu, Uu, Rr, Cud, Rr, Cud, Cud, Cud, Rr, Cud, Rr, Rr, Rr, Uu, Uu, Xu, Uu, Xu, Uu, Xu, Xu, Xu, Xu, Xu, Xu, Xu, Xu, Xu, Xu, Qxu, Uh, Uh, Uh, Uu, Uu, Uu, Uu, Uh, Uh, Uu, Uu, Qxu, Xu, Uu, Uu, Uu^Tf, Uu^Tf, Uu, Xu, Xu, Xu, Xu, Xu, Xu, Xu
Xu, Xu, Xu, Xu, Xu, Xu, Xu, Uu^Vud, Uu, Cud, Cud, Cud, Cud, Cud, Cud, Cud, Cud, Cud, Rr, Rr, Uu, Xu, Uu, Xu, Uu, Xu, Xu, Xu, Xu, Xu, Xu, Xu, Xu, Xu, Xu, Xu, Xu, Uh, Qxu, Qxu, Uu, Uu^Tf, Uu^Tf, Xu, Uh, Uh, Uh, Uu, Uu, Qxu, Uu, Uu, Xu, Uu^Tf, Xu, Uu, Uu, Xu, Xu, Xu, Xu, Xu
Xu, Xu, Xu, Xu, Xu, Xu, Xu, Uu, Uu, Cud, Cud, Rr, Rr, Cud, Rr, Rr, Cud, Cud, Uu, Uu, Uu, Xu, Uu, Uu, Uu, Uu, Xu, Xu, Xu, Xu, Xu, Xu, Xu, Xu, Xu, Xu, Xu, Xu, Xu, Uu, Xu, Uu^Tf, Xu, Uu^Tf, Xu, Uh, Uh, Uu, Uu, Uu, Uh, Uu, Xu, Xu, Xu, Xu, Uu, Xu, Xu, Xu, Xu, Xu
Xu, Xu, Xu, Xu, Xu, Xu, Xu, Uu^Vud, Rr, Rr, Rr, Rr, Rr, Rr, Rr, Rr, Rr, Rr, Uu^Vud, Uu, Uu^Vud, Xu, Uu^Vud, Uu, Uu, Uu, Xu, Xu, Xu, Xu, Xu, Xu, Xu, Xu, Xu, Xu, Xu, Xu, Xu, Uu, Xu, Xu, Xu, Xu, Xu, Uh, Uu, Uu, Uh, Uh, Xu, Uh, Xu, Xu, Xu, Xu, Uh, Xu, Xu, Xu, Xu, Xu
Xu, Xu, Xu, Xu, Xu, Xu, Xu, Xu, Xu, Cud, Cud, Rr, Rr, Kud, Rr, Rr, Cud, Cud, Xu, Xu, Xu, Xu, Xu, Xu, Xu, Xu, Xu, Xu, Xu, Xu, Xu, Xu, Xu, Xu, Xu, Xu, Xu, Xu, Xu, Uu, Xu, Xu, Xu, Xu, Xu, Uu, Xu, Xu, Xu, Xu, Xu, Xu, Xu, Xu, Xu, Xu, Xu, Uu^Tf, Xu, Xu, Xu, Xu
Xu, Xu, Xu, Xu, Xu, Xu, Xu, Xu, Xu, Xu, Xu, Cud, Rr, Rr, Rr, Cud, Xu, Xu, Xu, Xu, Xu, Xu, Xu, Xu, Xu, Xu, Xu, Xu, Xu, Xu, Xu, Xu, Xu, Xu, Xu, Xu, Xu, Xu, Xu, Uu, Xu, Xu, Xu, Xu, Xu, Xu, Xu, Xu, Xu, Xu, Qxu, Xu, Uu, Xu, Xu, Xu, Uu, Uu, Xu, Xu, Xu, Xu
Xu, Xu, Xu, Xu, Xu, Xu, Xu, Xu, Xu, Xu, Xu, Xu, Rr, Rr, Rr, Xu, Xu, Xu, Xu, Xu, Xu, Xu, Xu, Xu, Xu, Xu, Xu, Xu, Xu, Xu, Xu, Xu, Xu, Xu, Xu, Xu, Xu, Xu, Xu, Xu, Xu, Xu, Xu, Xu, Xu, Xu, Xu, Xu, Xu, Qxu, Uu, Uu, Xu, Uu, Uh, Uu, Xu, Xu, Xu, Xu, Xu, Xu
Xu, Xu, Xu, Xu, Xu, Xu, Xu, Xu, Xu, Xu, Xu, Xu, Rr, Rr, Rr, Xu, Xu, Xu, Xu, Xu, Xu, Xu, Kud, Xu, Kud, Xu, Xu, Xu, Xu, Xu, Xu, Xu, Xu, Xu, Xu, Xu, Uu, Uu^Vud, Uu^Vud, Xu, Xu, Xu, Xu, Xu, Xu, Xu, Xu, Xu, Xu, Xu, Uu, Qxu, Xu, Xu, Xu, Xu, Xu, Xu, Xu, Xu, Xu, Xu
Xu, Xu, Xu, Xu, Xu, Xu, Xu, Xu, Xu, Xu, Xu, Xu, Rr, Rr, Rr, Xu, Uu, Xu, Cud, Xu, Uu, Xu, Uu, Uu, Uu, Xu, Uu, Xu, Uu, Xu, Uu, Xu, Uu, Xu, Uu, Uu, Rr, Rr, Rr, Uu^Vud, Uu^Vud, Xu, Xu, Xu, Xu, Xu, Xu, Xu, Xu, Xu, Uu^Tf, Xu, Xu, Xu, Xu, Xu, Xu, Xu, Xu, Xu, Xu, Xu
Xu, Xu, Xu, Xu, Xu, Xu, Xu, Xu, Xu, Xu, Xu, Xu, Cud, Rr, Rr, Uu, Rr, Uu, Rr, Uu, Rr, Uu, Rr, Kud, Rr, Uu, Rr, Uu, Rr, Uu, Rr, Uu, Rr, Cud, Rr, Rr, Cud, Cud, Cud, Rr, Uu, Xu, Xu, Xu, Xu, Xu, Xu, Xu, Xu, Xu, Uu^Tf, Xu, Xu, Xu, Xu, Xu, Xu, Xu, Xu, Xu, Xu, Xu
Xu, Xu, Xu, Xu, Xu, Xu, Xu, Xu, Xu, Xu, Xu, Xu, Xu, Uu, Uu, Rr, Uu, Rr, Cud, Rr, Uu, Rr, Uu, Rr, Uu, Rr, Uu, Rr, Uu, Rr, Uu, Rr, Uu, Rr, Uu, Rr, Cud, 3 Kud, Cud, Rr, Uu, Xu, Xu, Xu, Xu, Xu, Xu, Xu, Xu, Qxu, Qxu, Uu, Uu, Xu, Xu, Xu, Xu, Xu, Xu, Xu, Xu, Xu
Xu, Xu, Xu, Xu, Xu, Xu, Xu, Xu, Xu, Xu, Xu, Xu, Xu, Xu, Xu, Uu, Xu, Uu, Xu, Uu, Xu, Uu, Uu, Kud, Uu, Uu, Xu, Uu, Xu, Uu, Xu, Uu, Xu, Cud, Uu, Rr, Rr, Cud, Rr, Rr, Uu, Xu, Xu, Xu, Xu, Xu, Xu, Xu, Xu, Xu, Xu, Xu, Xu, Uu, Uu, Xu, Xu, Xu, Xu, Xu, Xu, Xu
Xu, Xu, Xu, Xu, Xu, Xu, Xu, Xu, Xu, Xu, Xu, Xu, Xu, Xu, Xu, Xu, Xu, Xu, Xu, Xu, Xu, Xu, Kud, Uu, Kud, Xu, Xu, Xu, Xu, Xu, Xu, Xu, Xu, Xu, Xu, Uu, Cud, Rr, Cud, Uu, Xu, Xu, Xu, Xu, Xu, Xu, Xu, Xu, Xu, Xu, Xu, Xu, Xu, Xu, Uu, Uh, Xu, Xu, Xu, Xu, Xu, Xu
Xu, Xu, Xu, Xu, Xu, Xu, Xu, Xu, Xu, Xu, Xu, Xu, Xu, Xu, Xu, Xu, Xu, Xu, Xu, Xu, Xu, Xu, Xu, Xu, Xu, Xu, Xu, Xu, Xu, Xu, Xu, Xu, Xu, Xu, Xu, Xu, Uu, Rr, Uu, Xu, Xu, Xu, Xu, Xu, Xu, Xu, Xu, Xu, Xu, Xu, Xu, Xu, Xu, Xu, Xu, Uh, Xu, Xu, Xu, Xu, Xu, Xu
Xu, Xu, Xu, Xu, Xu, Xu, Xu, Xu, Xu, Xu, Xu, Xu, Xu, Xu, Xu, Xu, Xu, Xu, Xu, Xu, Xu, Xu, Xu, Xu, Xu, Xu, Xu, Xu, Xu, Xu, Xu, Xu, Xu, Xu, Xu, Xu, Uu, Rr, Uu, Xu, Xu, Xu, Xu, Xu, Xu, Xu, Xu, Xu, Xu, Xu, Xu, Xu, Xu, Xu, Xu, Uu, Xu, Xu, Xu, Xu, Xu, Xu
Xu, Xu, Xu, Xu, Xu, Xu, Xu, Xu, Xu, Xu, Xu, Xu, Xu, Xu, Uu, Uu, Uu, Xu, Xu, Xu, Xu, Xu, Xu, Xu, Xu, Xu, Xu, Xu, Xu, Xu, Xu, Xu, Xu, Xu, Xu, Xu, Uu, Rr, Uu, Xu, Xu, Xu, Xu, Xu, Xu, Xu, Xu, Xu, Xu, Xu, Xu, Xu, Xu, Xu, Qxu, Uu, Xu, Xu, Xu, Xu, Xu, Xu
Xu, Xu, Xu, Xu, Xu, Xu, Xu, Xu, Xu, Xu, Xu, Xu, Xu, Xu, Xu, Uu, Xu, Xu, Xu, Xu, Xu, Xu, Xu, Xu, Xu, Xu, Xu, Xu, Xu, Xu, Xu, Xu, Xu, Xu, Xu, Xu, Cud, Rr, Uu, Xu, Xu, Xu, Xu, Xu, Xu, Xu, Xu, Xu, Xu, Xu, Xu, Xu, Xu, Xu, Uh, Uu, Uu, Xu, Xu, Xu, Xu, Xu
Xu, Xu, Xu, Xu, Xu, Xu, Xu, Xu, Xu, Xu, Xu, Xu, Xu, Xu, Xu, Xu, Xu, Xu, Xu, Xu, Xu, Xu, Xu, Xu, Xu, Xu, Xu, Xu, Xu, Xu, Xu, Xu, Xu, Xu, Uu, Uu, Rr, Rr, Cud, Xu, Xu, Xu, Xu, Xu, Xu, Xu, Xu, Xu, Xu, Xu, Xu, Xu, Xu, Xu, Xu, Xu, Uu, Xu, Xu, Xu, Xu, Xu
Xu, Xu, Xu, Xu, Xu, Xu, Xu, Xu, Xu, Uu, Kud, Uu, Kud, Uu, Kud, Uu, Kud, Uu, Kud, Uu, Kud, Uu, Xu, Xu, Xu, Xu, Xu, Xu, Xu, Xu, Xu, Xu, Uu, Uu, Rr, Rr, Uu, Uu, Xu, Xu, Xu, Xu, Xu, Xu, Xu, Xu, Xu, Xu, Xu, Xu, Xu, Xu, Xu, Xu, Xu, Xu, Uu, Qxu, Xu, Xu, Xu, Xu
Xu, Xu, Xu, Xu, Xu, Xu, Xu, Xu, Uu, Xu, Rr, Xu, Rr, Xu, Rr, Xu, Rr, Xu, Rr, Xu, Rr, Xu, Xu, Xu, Xu, Xu, Xu, Xu, Uu^Vud, Xu, Cud, Uu, Rr, Rr, Uu, Uu, Xu, Xu, Xu, Xu, Xu, Xu, Xu, Xu, Xu, Xu, Xu, Xu, Xu, Xu, Xu, Xu, Xu, Xu, Xu, Xu, Uu, Qxu, Xu, Xu, Xu, Xu
Xu, Xu, Xu, Xu, Xu, Xu, Uu, Uu, Uu, Uu, Rr, Uu, Rr, Uu, Rr, Uu, Rr, Uu, Rr, Uu, Rr, Uu, Xu, Xu, Xu, Xu, Cud, Uu^Vud, Uu, Uu, Rr, Rr, Cud, Uu, Xu, Xu, Xu, Xu, Xu, Xu, Xu, Xu, Xu, Xu, Xu, Xu, Xu, Xu, Xu, Xu, Xu, Xu, Xu, Uu^Tf, Uu^Tf, Uh, Xu, Xu, Xu, Xu, Xu, Xu
Xu, Xu, Uu, Uu, Uu, Uu, Xu, Uu, Uu, Uu, Rr, Uu, Rr, Uu, Rr, Uu, Rr, Uu, Rr, Uu, Rr, Uu, Uu, Uu, Uu, Uu, Uu, Uu, Cud, Cud, Cud, Uu, Uu^Vud, Xu, Xu, Xu, Xu, Xu, Xu, Xu, Xu, Xu, Xu, Xu, Xu, Xu, Xu, Xu, Xu, Xu, Xu, Xu, Uu, Uu, Xu, Xu, Xu, Xu, Xu, Xu, Xu, Xu
Xu, Uu, Ce, Ce, Ce, Rr, Rr, Rr, Rr, Rr, Rr, Rr, Rr, Rr, Rr, Rr, Rr, Rr, Rr, Rr, Rr, Rr, Rr, Rr, Rr, Rr, Rr, Rr, Cud, 8 Kud, Cud, Uu, Uu^Vud, Xu, Xu, Xu, Xu, Xu, Xu, Xu, Xu, Xu, Xu, Xu, Xu, Xu, Xu, Xu, Xu, Xu, Xu, Uh, Uh, Xu, Xu, Xu, Xu, Xu, Xu, Xu, Xu, Xu
Xu, Uu, Ce, 1 Ke, Ce, Rr, Rr, Rr, Rr, Rr, Rr, Rr, Rr, Rr, Rr, Rr, Rr, Rr, Rr, Rr, Rr, Rr, Uu, Uu, Uu, Uu, Cud, Uu, Uu, Cud, Rr, Uu, Cud, Xu, Xu, Xu, Xu, Xu, Xu, Xu, Xu, Xu, Xu, Xu, Xu, Xu, Xu, Xu, Xu, Xu, Xu, Uh, Uu, Xu, Xu, Xu, Xu, Xu, Xu, Xu, Xu, Xu
Xu, Uu, Uu, Ce, Uu, Uu, Xu, Uu, Uu, Uu, Rr, Uu, Rr, Uu, Rr, Uu, Rr, Uu, Rr, Uu, Rr, Uu, Xu, Xu, Xu, Xu, Xu, Uu^Vud, Uu^Vud, Uu, Cud, Rr, Rr, Uu, Uu, Xu, Xu, Xu, Xu, Xu, Xu, Xu, Xu, Xu, Xu, Xu, Xu, Xu, Xu, Xu, Xu, Xu, Xu, Uu, Xu, Xu, Xu, Xu, Xu, Xu, Xu, Xu
Xu, Xu, Xu, Uu, Uu, Uu, Uu, Uu, Uu, Uu, Rr, Uu, Rr, Uu, Rr, Uu, Rr, Uu, Rr, Uu, Rr, Uu, Xu, Xu, Xu, Xu, Xu, Xu, Xu, Xu, Xu, Uu, Uu, Rr, Rr, Uu, Uu, Xu, Xu, Xu, Xu, Xu, Xu, Xu, Xu, Xu, Xu, Xu, Xu, Xu, Xu, Xu, Uh, Uu, Uu, Xu, Xu, Xu, Xu, Xu, Xu, Xu
Xu, Xu, Xu, Xu, Xu, Uu, Xu, Uu, Uu, Uu, Rr, Uu, Rr, Uu, Rr, Uu, Rr, Uu, Rr, Uu, Rr, Uu, Xu, Xu, Xu, Xu, Xu, Xu, Xu, Xu, Xu, Xu, Xu, Uu, Uu, Rr, Rr, Cud, Uu, Xu, Xu, Xu, Xu, Xu, Xu, Xu, Xu, Xu, Xu, Xu, Uu^Tf, Xu, Uu, Uu, Xu, Uu, Xu, Xu, Xu, Xu, Xu, Xu
Xu, Xu, Xu, Xu, Xu, Xu, Xu, Xu, Xu, Xu, Kud, Xu, Kud, Xu, Kud, Xu, Kud, Xu, Kud, Xu, Kud, Xu, Xu, Xu, Xu, Xu, Xu, Xu, Xu, Xu, Xu, Xu, Xu, Xu, Xu, Cud, Uu, Rr, Rr, Uu, Uu, Xu, Xu, Xu, Xu, Xu, Xu, Xu, Xu, Uu, Xu, Uu^Tf, Uu, Xu, Xu, Xu, Xu, Xu, Xu, Xu, Xu, Xu
Xu, Xu, Xu, Xu, Xu, Xu, Xu, Xu, Xu, Uu, Xu, Uu, Xu, Uu, Xu, Uu, Xu, Uu, Xu, Uu, Xu, Uu, Xu, Xu, Xu, Xu, Xu, Xu, Xu, Xu, Xu, Xu, Uu, Xu, Rr, Xu, Rr, Uu, Uu, Rr, Uu, Xu, Rr, Xu, Rr, Xu, Uu, Xu, Xu, Xu, Xu, Xu, Xu, Xu, Uu^Vud, Xu, Qxu, Qxu, Uh, Uu^Vud, Xu, Xu
Xu, Xu, Xu, Xu, Xu, Xu, Xu, Xu, Xu, Xu, Xu, Xu, Xu, Xu, Xu, Xu, Xu, Xu, Xu, Xu, Xu, Xu, Xu, Xu, Xu, Xu, Xu, Xu, Xu, Xu, Xu, Xu, Uu, Uu^Vud, Rr, Rr, Rr, Cud, Rr, Rr, Rr, Cud, Rr, Rr, Rr, Uu^Vud, Uu, Xu, Xu, Xu, Xu, Xu, Xu, Xu, Uu^Tf, Uu, Uu, Uh, Chr, Chr, Uh, Xu
Xu, Xu, Xu, Xu, Xu, Xu, Xu, Xu, Xu, Xu, Xu, Xu, Xu, Xu, Uu, Uu, Uu, Xu, Xu, Xu, Xu, Xu, Xu, Xu, Xu, Xu, Xu, Xu, Xu, Xu, Xu, Xu, Rr, Uu, Rr, Cud, Rr, Cud, Cud, Rr, Cud, Cud, Rr, Cud, Rr, Uu, Rr, Xu, Xu, Xu, Xu, Xu, Xu, Uu^Vud, Uu^Tf, Uh, Uu, Chr, Chr, Chr, Uu^Tf, Xu
Xu, Xu, Xu, Xu, Xu, Xu, Xu, Xu, Xu, Xu, Xu, Xu, Xu, Xu, Xu, Uu, Xu, Xu, Xu, Xu, Xu, Xu, Xu, Xu, Xu, Uh, Qxu, Xu, Xu, Xu, Cud, Cud, Rr, Uu^Vud, Rr, Cud, Rr, Cud, Cud, 5 Kud, Cud, Cud, Rr, Cud, Rr, Uu^Vud, Rr, Cud, Cud, Xu, Xu, Xu, Xu, Qxu, Qxu, Uu^Tf, Uu, 6 Khr, Chr, Uu, Uu^Tf, Xu
Xu, Xu, Xu, Xu, Xu, Xu, Xu, Xu, Xu, Xu, Xu, Xu, Qxu, Xu, Uu, Xu, Uu, Uh, Xu, Xu, Xu, Xu, Xu, Xu, Xu, Uu^Vud, Qxu, Xu, Xu, Xu, Cud, Xu, Rr, Rr, Rr, Cud, Rr, Cud, Cud, Cud, Cud, Cud, Rr, Cud, Rr, Rr, Rr, Xu, Cud, Xu, Xu, Xu, Uu, Xu, Uu, Uu, Uu, Chr, Uu, Uu, Uu^Tf, Xu
Xu, Xu, Xu, Xu, Xu, Xu, Xu, Xu, Xu, Xu, Xu, Qxu, Uu, Uu, Rd, Rd, Rd, Uh, Uh, Uu^Tf, Uu^Tf, Qxu, Qxu, Uu^Vud, Uu, Uu^Tf, Uh, Xu, Xu, Xu, Xu, Cud, Rr, Uu^Vud, Rr, Cud, Rr, Uu, Uu, Cud, Uu, Uu, Rr, Cud, Rr, Uu^Vud, Rr, Cud, Xu, Xu, Uu, Uu, Xu, Uu, Uu^Vud, Uu, Uu, Uu, Qxu, Uu^Vud, Uh, Xu
Xu, Xu, Xu, Xu, Xu, Xu, Xu, Xu, Xu, Xu, Uu^Tf, Uu, Rd, Xu, Rd, Xu, Xu, Rd, Rd, Rd, Rd, Uu^Vud, Rd, Uu, Cud, Uu^Tf, Uh, Uh, Xu, Xu, Xu, Xu, Uu, Uu, Rr, Rr, Rr, Uu^Vud, Rr, Rr, Rr, Uu^Vud, Uu, Rr, Rr, Uu, Rr, Xu, Xu, Qxu, Uu^Tf, Xu, Xu, Xu, Xu, Uh, Uu, Uu^Vud, Xu, Qxu, Xu, Xu
Xu, Xu, Xu, Xu, Xu, Xu, Xu, Xu, Uh, Uu^Tf, Rd, Rd, Xu, Rd, Uu, Xu, Xu, Xu, Xu, Xu, Xu, Rd, Cud, Rd, Rd, Uu, Cud, Uu^Vud, Uu, Xu, Uu^Tf, Xu, Xu, Xu, Xu, Xu, Xu, Xu, Xu, Xu, Xu, Xu, Xu, Xu, Xu, Xu, Xu, Xu, Xu, Qxu, Uu^Tf, Xu, Xu, Xu, Uu^Tf, Uh, Uu^Tf, Xu, Xu, Xu, Xu, Xu
Xu, Xu, Xu, Xu, Xu, Xu, Uh, Uu^Tf, Uh, Uh, Rd, Xu, Xu, Xu, Uu, Uu, Xu, Xu, Xu, Xu, Cud, Uu, Uu^Tf, Rd, Cud, Rd, Uh, Uu, Cud, Uh, Uh, Xu, Xu, Xu, Xu, Xu, Xu, Uu, Uu, Rd, Uu, Uu, Xu, Xu, Xu, Xu, Xu, Xu, Xu, Xu, Xu, Uu, Uu, Xu, Xu, Uu, Uu^Tf, Xu, Xu, Xu, Xu, Xu
Xu, Xu, Xu, Xu, Uu^Tf, Qxu, Uu, Uu, Uu, Rd, Xu, Xu, Xu, Xu, Uu, Xu, Xu, Xu, Uh, Uh, Cud, Uh, Uu^Tf, Cud, 2 Kud, Cud, Uh, Uu, Cud, Uh, Qxu, Xu, Xu, Xu, Xu, Xu, Xu, Xu, Uu, Rd, Uu, Xu, Uh, Xu, Xu, Xu, Xu, Xu, Xu, Xu, Xu, Xu, Xu, Uu, Uu, Uu, Uu, Uu, Uu, Xu, Xu, Xu
Xu, Xu, Xu, Xu, Uu^Tf, Uu, Uh, Uu, Uu, Rd, Xu, Xu, Xu, Xu, Xu, Uu, Uu, Uh, Uu, Uu^Vud, Cud, Uu, Rd, Cud, Cud, Cud, Uu, Uu^Tf, Cud, Uu, Qxu, Xu, Xu, Xu, Xu, Qxu, Uh, Xu, Rd, Rd, Uu^Tf, Xu, Uu, Uh, Xu, Xu, Xu, Xu, Xu, Xu, Xu, Xu, Xu, Uu, Xu, Qxu, Xu, Uu, Uu, Uh, Qxu, Xu
Xu, Xu, Xu, Xu, Xu, Xu, Xu, Uh, Uu, Rd, Uh, Xu, Xu, Xu, Xu, Xu, Xu, Xu, Xu, Uu, Uu, Uu, Cud, Rd, Rd, Rd, Cud, Uu, Uu^Tf, Uu^Vud, Xu, Xu, Uh, Uh, Uh, Uh, Rd, Rd, Xu, Uu^Tf, Uu, Uu, Uu, Uh, Uh, Xu, Xu, Xu, Xu, Xu, Xu, Xu, Qxu, Uu, Xu, Xu, Xu, Xu, Uu, Uu^Tf, Xu, Xu
Xu, Xu, Xu, Xu, Xu, Xu, Xu, Uu, Uu, Rd, Uu^Tf, Xu, Xu, Xu, Xu, Xu, Qxu, Xu, Uu^Tf, Uh, Uh, Uu^Vud, Uu, Rd, Cud, Uu, Uu, Uu^Tf, Xu, Uu^Tf, Xu, Xu, Xu, Qxu, Qxu, Uu^Tf, Uu, Rd, Uu, Xu, Uu, Uu, Uu, Xu, Qxu, Uu^Tf, Xu, Xu, Xu, Xu, Xu, Xu, Xu, Uu, Xu, Xu, Xu, Xu, Uu, Uh, Xu, Xu
Xu, Xu, Xu, Xu, Xu, Xu, Uh, Uu^Tf, Uu, Rd, Rd, Uh, Xu, Xu, Xu, Xu, Xu, Uu^Vud, Xu, Uh, Uh, Uu, Uu, Uu, Uu, Uu, Uh, Uh, Xu, Xu, Xu, Xu, Xu, Xu, Xu, Xu, Xu, Rd, Rd, Uu, Uu, Uu, Qxu, Qxu, Xu, Xu, Xu, Xu, Xu, Xu, Xu, Xu, Qxu, Uu, Uu, Xu, Xu, Uu, Uu, Uu^Tf, Xu, Xu
Xu, Xu, Xu, Uh, Uh, Uh, Uh, Uh, Uu^Tf, Uu^Tf, Rd, Uu, Uu^Tf, Uu^Tf, Uh, Xu, Qxu, Xu, Xu, Xu, Xu, Xu, Qxu, Uu^Vud, Uu^Tf, Uu, Uu, Uu^Vud, Xu, Xu, Xu, Xu, Xu, Xu, Xu, Xu, Uu, Uu, Rd, Uu, Xu, Xu, Xu, Xu, Xu, Xu, Xu, Xu, Xu, Xu, Xu, Xu, Qxu, Xu, Xu, Uu, Uh, Uu, Qxu, Xu, Xu, Xu
Xu, Xu, Uu, Uu, Uu, Uu, Uu, Uu, Uu, Ch, Ch, Rd, Rd, Uh, Uh, Uh, Qxu, Qxu, Uh, Xu, Xu, Xu, Xu, Qxu, Uu^Tf, Uu^Tf, Uu, Xu, Xu, Xu, Uu, Xu, Xu, Xu, Uu, Xu, Uu, Xu, Rd, Uh, Uh, Xu, Xu, Xu, Xu, Xu, Xu, Xu, Xu, Xu, Xu, Xu, Qxu, Xu, Xu, Xu, Uh, Uu, Xu, Xu, Xu, Xu
Xu, Xu, Uu, Xu, Uu, Uu^Vud, Uu^Tf, Ch, Ch, Uu, Uu, Uu^Vud, Qxu, Rd, Rd, Uh, Uu^Tf, Uu, Uu, Uh, Xu, Xu, Xu, Xu, Xu, Xu, Xu, Xu, Uh, Uu, Uu, Uu, Uu, Uu, Xu, Uu, Xu, Xu, Rd, Xu, Xu, Uu, Uu, Xu, Xu, Xu, Qxu, Qxu, Uu^Tf, Qxu, Qxu, Qxu, Xu, Xu, Xu, Xu, Uu, Uu, Xu, Xu, Xu, Xu
Xu, Xu, Uu^Tf, Uu, Uu, Qxu, Xu, Xu, Chr, Uu, Chr, Uu, Rd, Qxu, Rd, Uu^Tf, Uu, Uu, Uu, Uh, Xu, Xu, Xu, Xu, Xu, Xu, Xu, Uh, Qxu, Xu, Xu, Xu, Rd, Rd, Rd, Xu, Rd, Rd, Xu, Xu, Xu, Xu, Uu, Uu, Uu, Uu, Uu, Uu^Tf, Uu^Tf, Uu^Tf, Xu, Xu, Xu, Xu, Xu, Qxu, Uu, Uu, Qxu, Xu, Xu, Xu
Xu, Xu, Xu, Uu^Tf, Uu^Vud, Qxu, Qxu, Chr, 7 Khr, Chr, Rd, Rd, Chr, Rd, Uu^Vud, Rd, Rd, Uu, Rd, Uu, Uu, Uu^Tf, Xu, Xu, Xu, Uh, Uu^Tf, Uu^Tf, Rd, Xu, Rd, Rd, Uu, Uu, Uu, Rd, Uu, Uu, Uu^Tf, Xu, Xu, Xu, Xu, Xu, Xu, Xu, Uu, Uu, Uu, Uu, Xu, Xu, Xu, Xu, Uh, Uu, Xu, Uu, Uu, Qxu, Uh, Xu
Xu, Xu, Xu, Uu^Tf, Uu^Tf, Uu, Ch, Chr, Chr, Chr, Uu, Uu, Uu, Uu, Uu, Uu, Uu, Rd, Uu, Rd, Rd, Xu, Rd, Xu, Rd, Rd, Rd, Rd, Uu, Rd, Uu^Tf, Uu, Uh, Uh, Xu, Qxu, Xu, Uu, Uh, Uu^Tf, Xu, Xu, Xu, Xu, Xu, Xu, Xu, Uu, Uu, Uu^Tf, Xu, Xu, Qxu, Xu, Uu, Xu, Xu, Xu, Uu, Uu, Uu^Tf, Xu
Xu, Xu, Xu, Xu, Xu, Uu, Xu, Xu, Xu, Ch, Ch, Uu, Uu, Uu^Vud, Uu^Tf, Qxu, Qxu, Uu^Tf, Uu^Tf, Uu^Tf, Xu, Xu, Rd, Rd, Uu, Uu, Uu, Uu, Uu^Tf, Uu^Tf, Xu, Xu, Xu, Xu, Xu, Xu, Qxu, Qxu, Uh, Uh, Xu, Xu, Xu, Xu, Xu, Xu, Xu, Xu, Uu, Uu^Tf, Xu, Qxu, Uu, Uu, Uu, Uu, Uu, Xu, Uu, Xu, Xu, Xu
Xu, Xu, Xu, Xu, Uu, Uu, Ch, Uu, Uu, Ch, Uu, Uu, Uu, Uu^Tf, Xu, Qxu, Xu, Qxu, Xu, Uu^Tf, Xu, Xu, Xu, Xu, Uh, Uu, Qxu, Xu, Xu, Xu, Xu, Xu, Xu, Xu, Xu, Xu, Xu, Xu, Xu, Xu, Xu, Xu, Xu, Xu, Xu, Xu, Qxu, Uu, Uu, Qxu, Xu, Xu, Uu, Xu, Qxu, Uu, Uu^Tf, Uu, Uh, Xu, Xu, Xu
Xu, Xu, Xu, Xu, Uu, Ch, Ch, Xu, Qxu, Uu, Uu, Uu, Uu^Tf, Uu^Tf, Xu, Xu, Xu, Xu, Xu, Xu, Xu, Xu, Xu, Uh, Uh, Qxu, Xu, Qxu, Xu, Xu, Xu, Xu, Xu, Xu, Xu, Xu, Xu, Xu, Xu, Xu, Xu, Xu, Xu, Xu, Xu, Xu, Xu, Uu, Uu, Uu, Uu, Uu, Uu, Uu, Uu^Tf, Uu^Tf, Qxu, Uu, Uh, Uu, Xu, Xu
Xu, Xu, Xu, Xu, Uu, Xu, Uu, Uu, Qxu, Uu^Vud, Qxu, Uu, Xu, Xu, Xu, Xu, Xu, Xu, Xu, Xu, Xu, Xu, Xu, Xu, Xu, Xu, Xu, Xu, Xu, Xu, Xu, Xu, Xu, Xu, Xu, Xu, Xu, Xu, Xu, Xu, Xu, Xu, Xu, Xu, Xu, Xu, Xu, Xu, Xu, Uu^Tf, Uu^Tf, Uu, Xu, Uh, Uh, Xu, Xu, Qxu, Uu, Uu, Xu, Xu
Xu, Xu, Xu, Uu, Uu^Tf, Uu^Tf, Uu^Tf, Uu^Tf, Uh, Uh, Uh, Uu, Uu, Uu, Uu, Xu, Xu, Xu, Xu, Xu, Xu, Xu, Xu, Xu, Xu, Xu, Xu, Xu, Xu, Xu, Xu, Xu, Xu, Xu, Xu, Xu, Xu, Xu, Xu, Xu, Xu, Xu, Xu, Xu, Xu, Xu, Xu, Xu, Xu, Uu^Tf, Xu, Xu, Xu, Xu, Xu, Xu, Xu, Xu, Xu, Xu, Xu, Xu
Xu, Xu, Xu, Xu, Xu, Xu, Xu, Uh, Uh, Uh, Xu, Xu, Xu, Xu, Xu, Xu, Xu, Xu, Xu, Xu, Xu, Xu, Xu, Xu, Xu, Xu, Xu, Xu, Xu, Xu, Xu, Xu, Xu, Xu, Xu, Xu, Xu, Xu, Xu, Xu, Xu, Xu, Xu, Xu, Xu, Xu, Xu, Xu, Xu, Xu, Xu, Xu, Xu, Xu, Xu, Xu, Xu, Xu, Xu, Xu, Xu, Xu
Xu, Xu, Xu, Xu, Xu, Xu, Xu, Xu, Xu, Xu, Xu, Xu, Xu, Xu, Xu, Xu, Xu, Xu, Xu, Xu, Xu, Xu, Xu, Xu, Xu, Xu, Xu, Xu, Xu, Xu, Xu, Xu, Xu, Xu, Xu, Xu, Xu, Xu, Xu, Xu, Xu, Xu, Xu, Xu, Xu, Xu, Xu, Xu, Xu, Xu, Xu, Xu, Xu, Xu, Xu, Xu, Xu, Xu, Xu, Xu, Xu, Xu
